11111111111111111111111111111111
10000000001111110010100000000001
11000010000000000000011111000001
11100000001100000001100000000001
1111111E111111110000100000001101
10000001000000000000100000001101
11111111111111100001100000001011
11111111111111100P01100000001011
11111111111111100001100000001011
10000000000000000111111100011111
11111111111111111111111111111111