  NO textures/berlin.png
SO textures/wall.png
EA textures/ussr.png
WE textures/us.png



   F 32,32,32
C 5,6,44


1111111111111111
1111111111 
1111110N00111111  1
1111000000111111          
111111111111111   1