NO textures/berlin oo.png
SO textures/wall.png 
EA textures/ussr.png


C  4,66,65

F   88,8,85



WE textures/us.png

11111
11101
10111111
111001001
111N00011
111111111










