  NO text ures/berlin.png
SO text ures/wall.png
EA text ures/ussr.png
WE text ures/us.png




   F 32,32,32
C 5,6,44


1111111
1N00001
1111111