  NO textures/berlin.png
SO textures/wall.png
EA textures/ussr.png
WE textures/us.png




   F 32,32,32
C 5,6,44


11111111111111111111111
1N0000111111111111111111111
111000000000000000011101101
   110000000000011111111111
111111111111111111111111