NO textures/berlin oo.png
SO textures/wall.png
EA textures/ussr.png
WE textures/us.png

C    25,  167,   206  
F 88,  8,85  


111111111111111111111111
11000W000000000000000001
111111111111111111111111
100000000000000000000001
100011111111110000000001
100000000000000000000001
100000100000000000000001
100000100000000000000001
100000101110000000000001
100000010011001000000001
100010000000000000000001
100010000000000111000001
100010000000000001000001
100000000000000111110001
100000000000000000000001
100000010000000000000001
100000010011001000000001
100011111110001000000001
100010000000000000000001
100010000000000111000001
100010000000000001000001
100000000000000111110001
1000000000000000000000011
1111111111111111111111111