NO textures/berlin oo.png
SO textures/wall.png 
EA textures/ussr.png
WE textures/us.png
C  0, 0, 100
F   88,8,85
    11111111
      101111111
        100N0001
	111111111111