          NO        textures/berlin oo.png            
SO textures/wall.png
EA textures/ussr.png
WE textures/us.png



   F 32,32,54,
C 5,6,44


1111
111N1
10001
1011
 1