NO textures/berlin oo.png
SO textures/wall.png
EA textures/ussr.png
WE textures/us.png

C   88,22,33
F   88,8,85  

111111111111111111111111
11000W000000000000000001
1111111111111111111111111







                
                                








