NO textures/berlin oo.png
SO textures/wall.png 
EA textures/ussr.png
WE textures/us.png
C  0, 0, 100
F   88,8,85


  1111111111111111111
  1000000000000000111
111000000N00000001
1000000000000000111
1000000000000000111
1111111111111111111